v
XXXXXXXX
XXXXXoEX
Xv<<<ovX
Xvoo^ovX
XvoX^<<X
XvoXXXXX
XPoXXXXX
XXXXXXXX