>
XoXXXP<X
X>>>vo^X
E^XXvX^X
XXXXvX^X
Xv<<<X^o
XvXoXX^X
X>>>>>^X
XXXXXXXX