^
>>>>>>>v
EooXXoov
XooXXoov
v<<<<<<<
vooXXooX
vooXXooP
vooXXoo^
>>>>>>>^